         ##########
        #   O      #
        #          #
       #        X   #
      #   O          #
    #########         ##
    ##    X      ## ####
    ##                ##
    ##       P   X    ##
    ##   X            ##
    ##                ##
      #        O     #
       #            #
        #    O     #
        #          #
         ##########